XXXXXXXXXXXXXXXXXXXXXXXXXXXXXXXXXXXXXXXX
X  S             X                    X
X X            XXX                   X
X X             X                    X
X XXXXXXXXXXXXXXXX XXXXXXXXXXXXXXXXX X
X X             X                    X
X X             X                    X
X X             X                    X
X X             X                    X
X X             X                    X
X X             X                    X
X X             X                    X
X X             X                    X
X XXXXXXXXXXXXXXXX XXXXXXXXXXXXXXXXX X
X X             X                    X
X X             X                    X
X X             X                    X
X X             X                    X
X X             X                    X
X XXXXXXXXXXXXXXXX XXXXXXXXXXXXXXXXX X
X X             X                    X
X X             X                    X
X X             X                    X
X X             X                    X
X X             X                    X
X XXXXXXXXXXXXXXXX XXXXXXXXXXXXXXXXX X
X X             X                    X
X X             X                    X
X X             X                    X
X X             X                    X
X X             X                    X
X XXXXXXXXXXXXXXXX XXXXXXXXXXXXXXXXX X
X X             X                    X
X X             X                    X
X X             X                    X
X X             X                    X
X X             X                    X
X  F            X                    X
XXXXXXXXXXXXXXXXXXXXXXXXXXXXXXXXXXXXXXXX
